0,1,2,3,1,2,3,1,2,3,4
9,10,11,12,10,11,12,10,11,12,13
16,19,11,18,10,11,12,10,11,12,20
9,17,17,12,18,11,11,12,11,12,20
9,19,11,12,10,17,12,10,11,12,13
9,10,11,12,10,11,12,10,11,12,13
24,25,26,27,25,26,27,25,26,27,28